2 2 2 2 2 2 2 2 2 2 2 2 2 2 2 2
2 0 0 0 0 0 1 0 0 0 0 0 0 0 0 2
2 0 1 0 0 0 0 0 0 0 0 0 0 1 0 2
2 0 0 0 0 0 0 0 0 0 0 0 0 0 0 2
2 0 0 0 0 0 0 0 0 0 0 0 0 0 0 2
2 0 0 0 0 0 0 0 0 1 0 0 0 0 0 0
2 0 0 0 0 0 0 0 0 0 0 0 0 1 0 0
2 0 0 0 0 0 0 0 0 0 0 1 0 0 0 2
2 0 1 0 0 0 0 0 0 0 0 0 0 0 0 2
4 4 5 0 1 0 0 0 0 0 0 0 0 0 0 2
3 3 3 4 5 0 0 0 1 0 0 0 0 0 0 2
3 3 3 3 3 4 2 2 2 2 2 2 2 2 2 2